######################################
#....................................#
#....................................#
#....................................#
#....................................#
#....................................#
#....................................#
#....................................#
#############...........##############
#############...........##############
#############...........##############
#.......................####.........#
#.......................####...E.....#
#.......................####.........#
#....................................#
#....................................#
#....................................#
#....................................#
#....................................#
######################################